[
    ["VID","VID","VID","VID","VID","VID","VID","VID","VID","VID","VID","VID","VID","VID","VID","VID","VID","VID","VID","VID","VID","VID"],
    ["VID","VID","VID","VID","VID","VID","VID","VID","VID","VID","VID","VID","VID","VID","VID","VID","VID","VID","SOL","SOL","SOL","SOL"],
    ["SOL","SOL","SOL","SOL","SOL","SOL","VID","VID","VID","VID","VID","VID","VID","VID","VID","VID","VID","VID","VID","VID","VID","VID"],
    ["VID","VID","VID","VID","VID","VID","VID","VID","VID","VID","VID","VID","VID","VID","VID","SOL","SOL","SOL","SOL","SOL","SOL","SOL"],
    ["VID","VID","SOL","SOL","SOL","SOL","SOL","SOL","VID","VID","VID","VID","VID","VID","VID","VID","VID","VID","VID","VID","VID","VID"],
    ["VID","VID","VID","VID","VID","VID","VID","VID","VID","SOL","SOL","SOL","SOL","SOL","SOL","VID","VID","VID","VID","VID","VID","VID"],
    ["VID","VID","VID","VID","VID","VID","VID","VID","VID","VID","VID","VID","VID","VID","VID","VID","VID","VID","VID","VID","VID","VID"],
    ["SOL","SOL","SOL","SOL","SOL","SOL","SOL","SOL","SOL","VID","VID","VID","VID","VID","VID","SOL","SOL","SOL","SOL","SOL","VID","VID"],
    ["VID","VID","VID","VID","VID","VID","VID","VID","VID","VID","VID","VID","VID","VID","VID","VID","VID","VID","VID","VID","VID","SOL"],
    ["VID","VID","VID","VID","VID","VID","VID","VID","VID","VID","SOL","SOL","SOL","SOL","SOL","SOL","VID","VID","VID","VID","SOL","SOL"],
    ["VID","VID","S__","VID","VID","VID","VID","VID","VID","VID","VID","VID","VID","VID","VID","VID","VID","VID","VID","VID","SOL","SOL"],
    ["SOL","SOL","SOL","SOL","SOL","SOL","SOL","SOL","SOL","SOL","SOL","SOL","SOL","SOL","SOL","SOL","SOL","SOL","SOL","SOL","SOL","SOL"]
]