[
    ["VID","VID","VID","VID","VID","VID","VID","VID","VID","VID","VID","VID","VID","VID","VID","VID","VID","VID","VID","VID","VID","VID"],
    ["SOL","SOL","SOL","SOL","VID","SOL","SOL","SOL","SOL","SOL","VID","SOL","SOL","SOL","SOL","SOL","SOL","SOL","VID","SOL","SOL","SOL"],
    ["SOL","SOL","SOL","SOL","VID","SOL","VID","VID","VID","VID","VID","VID","VID","VID","SOL","SOL","SOL","SOL","VID","SOL","SOL","SOL"],
    ["SOL","SOL","VID","VID","VID","VID","VID","VID","VID","VID","VID","VID","VID","VID","VID","VID","VID","SOL","VID","SOL","SOL","SOL"],
    ["SOL","VID","VID","SOL","SOL","SOL","SOL","SOL","SOL","SOL","SOL","SOL","SOL","SOL","SOL","SOL","VID","VID","VID","SOL","SOL","SOL"],
    ["SOL","VID","SOL","SOL","SOL","SOL","SOL","SOL","SOL","SOL","SOL","SOL","SOL","SOL","SOL","SOL","SOL","SOL","VID","VID","SOL","SOL"],
    ["SOL","VID","SOL","SOL","SOL","SOL","SOL","SOL","SOL","SOL","SOL","SOL","SOL","SOL","SOL","SOL","SOL","SOL","SOL","VID","VID","SOL"],
    ["SOL","VID","SP1","VID","VID","VID","VID","VID","SOL","SOL","SOL","SOL","SOL","SOL","SOL","SOL","SOL","SOL","SOL","SOL","VID","SOL"],
    ["SOL","SOL","SOL","SOL","SOL","SOL","VID","VID","SOL","SOL","SOL","SOL","SOL","SOL","SOL","SOL","SOL","VID","VID","VID","VID","SOL"],
    ["SOL","SOL","SOL","SOL","SOL","SOL","SOL","VID","VID","VID","VID","VID","VID","VID","SOL","SOL","SOL","VID","SOL","SOL","SOL","SOL"],
    ["SOL","SOL","SOL","SOL","SOL","SOL","SOL","SOL","SOL","SOL","SOL","SOL","SOL","VID","VID","VID","VID","VID","VID","VID","S__","SOL"],
    ["SOL","SOL","SOL","SOL","SOL","SOL","SOL","SOL","SOL","SOL","SOL","SOL","SOL","SOL","SOL","SOL","SOL","SOL","SOL","SOL","SOL","SOL"]
]