[
    ["VID","VID","VID","VID","VID","VID","VID","VID","VID","VID","VID","VID","VID","VID","VID","VID","VID","VID","VID","VID","VID","VID"],
    ["VID","VID","VID","VID","VID","VID","VID","VID","VID","VID","VID","VID","VID","VID","VID","VID","VID","VID","VID","VID","VID","VID"],
    ["VID","VID","VID","VID","VID","VID","VID","VID","VID","VID","VID","VID","VID","VID","VID","VID","VID","VID","VID","VID","VID","VID"],
    ["SOL","SOL","SOL","SOL","SOL","VID","VID","VID","VID","VID","VID","VID","VID","VID","VID","VID","VID","SOL","SOL","SOL","SOL","SOL"],
    ["VID","VID","VID","VID","SOL","SOL","SOL","SOL","SOL","VID","VID","VID","VID","SOL","SOL","SOL","SOL","SOL","VID","VID","VID","VID"],
    ["VID","VID","VID","VID","VID","VID","VID","VID","VID","VID","VID","VID","VID","VID","VID","VID","VID","VID","VID","VID","VID","VID"],
    ["VID","VID","VID","VID","VID","VID","VID","VID","VID","SOL","SOL","SOL","SOL","VID","VID","VID","VID","VID","VID","VID","SP1","VID"],
    ["VID","VID","VID","VID","VID","VID","VID","SOL","SOL","SOL","VID","VID","SOL","SOL","SOL","VID","VID","VID","VID","VID","VID","VID"],
    ["VID","VID","VID","VID","VID","VID","SOL","SOL","VID","VID","VID","VID","VID","VID","SOL","SOL","VID","VID","VID","VID","VID","VID"],
    ["VID","VID","VID","VID","VID","SOL","SOL","VID","VID","VID","VID","VID","VID","VID","VID","SOL","SOL","VID","VID","VID","S__","VID"],
    ["VID","VID","VID","VID","VID","VID","VID","VID","VID","VID","VID","VID","VID","VID","VID","VID","VID","VID","VID","VID","S__","VID"],
    ["SOL","SOL","SOL","SOL","SOL","SOL","SOL","SOL","SOL","SOL","SOL","SOL","SOL","SOL","SOL","SOL","SOL","SOL","SOL","SOL","SOL","SOL"]
]